  #########################################################################
A #             #     # #     #     #     #     #     #         #     #   #
# ### # # ##### ### # # ##### ### ### ##### ### ### ### ### # # ### # ### #
#     # # #     #   #   # #   #     #   #   # #   #       # # #     # #   #
# # ####### ##### # # # # ### # # # # ##### # ######### # # # ### ####### #
# #       #       # # # #     # # #   #   #     #       # # #   # #       #
### ##### ### ####### ##### ##### ##### ### ####### ### ### # ######### ###
#   # #   #       # # #         #   #       # # # # #   #   #       # #   #
# ### # # ##### # # ##### # ####### # ### ### # # ### ##### # # # ### ### #
# #     # # #   #   #   # # #       # # #           #     # # # #   #     #
##### ### # ### ####### # ### ##### # # # ### ########### ############# # #
#     #   # #   #     #   #   #   # # # # #     #           # # # #   # # #
# ### ##### # ### ##### ##### ### # ### # ### ##### ##### ### # # ### # ###
#   # # #         #           # # #     # #     #   # #         #         #
# ### # ### ######### # ##### # # ### # ### ####### # ##### ##### # # # ###
# #B# # # # #   # #   # #     # # #   #   #   # # # #           # # # #   #
# # # # # # # # # # ########### # ### ##### # # # ### ##### ######### # # #
#   # #       #             # # #           # # #     #   # # #   #   # # #
# ####### ### ####### # ##### # # ##### ####### # # ##### # # # # ####### #
# # #   # # # # #   # #       #   # # #     #     # #   #   # # #   # #   #
### ### ### # # ### ######### ### # # ####### # ####### ##### ### ### # # #
# #               # #   # #     #     # #   # # #         # #           # #
# # ### # ######### # # # # # # ### ### # ### # # ### ### # ####### ##### #
# #   # #   #     #   #     # #   # # # #     #   # # #       #     #   # #
# ##### ##### # ####### ### # ####### # ########### ####### # ### # ### ###
#   # # # #   #           # #   #         # #   #           # #   # #     #
# ### # # # # # ####### # ### ####### # ### # ########### ### ##### ### ###
#       #   # # # #     # # #   # #   # # #         #       #             #
# ############# # ##### ### # ### ### ### ### ##### ######### ### # # #####
# #       #     # # #       #       #   # # # #   #   # # #     # # # #   #
### ####### # ### # # # ### # # # ##### # # # ### # ### # ##### # ##### ###
#       #   # #       # # # # # #   # #   # # # #   # #         #     #   #
### # ######### ### ### # ### ####### ### # # # ### # # ### # # ### # # ###
# # # #     # #   # #   #       #   #       # #     # #   # # # #   #   # #
# # ##### # # # # ### ##### ### ### # # # # ### # ### # ############### # #
#   #   # # #   #   #   #     #     # # # # # # #   #   #   #         #   #
# ### # ### # # ##### ##### ######### # ### # ##### # ### ### ### ### ### #
#   # #       # #   #   # #     #   # # #     # # #   # #     #   #   # # #
### ### # ### # # ##### # # ### ### ### ### # # # ### # # ### ### ### # # #
# # #   # #   # # #     #   #   #       #   #   # # # #   # #   # #   # # #
# # # ######### # ### ############### # ####### # # # # ### # # # ### # ###
#       # #   # # #       # #     #   # # #   #     #     #   # # # #   # #
### # ### ### ### ### ##### # # ### # ### # # ### # # ##### ##### # ### # #
#   # # #     #   #   # #     # #   # #     # #   # #   #   #   # #       #
# # ### ##### ### # ### # # ### ### # ### ##### # ### ##### ### ### ### # #
# #         #     # #   # # # # #   # # # #   # # #       # #     # #   # #
# ### ##### # # ### # # # ### # # ##### # ### # ### ##### ##### # ### # ###
# # #     # # #       # #   #     #         # # # #   #     #   # # # #   #
### # ##### ####### # ######### # ### # ### # ### ##### # # ##### # # #####
#   #   # # #   #   #     # #   #     # #           # # # #   # #   #     #
# ### ### ##### ### ### ### # # ####### ### ### ### # # ### # # # # # #####
#                 # #     # # # # #   # #   # #   # # #   # # #   #       #
# # ### ########### ### ### ### # # # ### ### # ##### ####### ### ##### # #
# # #   # # #     # #   #   # # #   #     #     #   #   # # # #   # #   # #
### ##### # ### ### ### # # # ########### ### ##### ### # # ### ### # # ###
# #     # #           #   # #         #   # #   #     #       # # #   #   #
# # # ### # ############# ####### ### ##### # ### ### ### # # ### # # #####
#   # # #   #     # #   #   #     # # # #     #   #   #   # #   # # # #   #
# ##### ####### ### ### # ### # ### # # # ### ### ### ### # ##### ### # ###
# # # #   #             #   # #   #         # # #   #     # # #   # # # # #
### # # ### # # ##### # # ### ################# # ### ####### # # # # # # #
#           # # # # # #   #                 #       #   #   #   # #     # #
########### ##### # ### # ### ####### ########### # ### ### # ### ### ### #
#   #   #         # # # # # # # #   #     # #     # # #         #     # # #
### ### # ####### # # ### # # # # # # # ### # ####### # ### ####### ### # #
#               #   #     # # #   # # #   #     #       #     #       #   #
##### ### # # # ### ### # # # # # ### ### # ### # ######### ### # ##### ###
#   #   # # # #   # #   #     # #   #   #     # # #   #   #   # #         #
# ### # ####### # # ##### ##### # # ##### ##### # ### ### ########### ### #
#   # # #     # # #     # # #   # #   # #   # # #   #   #       # #     # #
# # # ##### ### ########### # ####### # # # # ##### # # ##### ### ####### #
# #         # # #         #   #       #   # #   #     #   #       #     # #
##### ##### # # ### ##### ### ### ##### ### ### ##### ### ### ##### ### # #
# # # #     # #   #     #     #   #   #   #     #   # # # #     # # #   # #
# # # ####### # # # ### # ### # # # ### ######### ### # ##### # # ##### # #
#   # # #     # # # #   # #   # #   #     # #     # #     # # #           #
# ### # ### ### ### # ##### # ####### ##### ### ### # # ### ### # #########
#   #   # #   #   # #   #   # #   #     #       #     # #   #   #   #     #
# ### ### ### # # ### # ####### ### # ##### # # ### ####### # # # # # ### #
#       #     # #     #       #   # # #     # #           #   # # #   # # #
### ### ### # ####### ##### ### # ### ### ### # ##### ##### # # ### ### # #
#     # #   #         #         # #   #     # #     #   #   # #   #   #   
######################################################################### 
