 ########################################### # # # # # # # # # # # #
 ########################################### # # # # # # # # # # # #
 ##A#           #         #                              #       # #
 ## # ######### # ##### # ##### ############ # # # # #   #   #   # #
 ## #   # #     # #     #       #   #            #   #   #   #   # #
 ## ### # # ####### ############# ### #####  #   #   #   #   #   # #
 ##     # #       # #     #   #       #      #       #   #   #   # #
 ######## ####### # # ### # # ### ##### #### # # #   #   # # #   # #
 ##       #       #     #   #   #   #   #    #       #       #   # #
 ## ####### ################### ##### ### ## #   # # # # #   #   # #
 ##         #   #       #       #     #   #      #           #   # #
 ## ######### # # # ### # ####### ##### ###  # # #   # # # # #   # #
 ##       #   # # # #   # #   #   #     #        #   #       #   # #
 ######## ### # # # # ### # ### # ##### # ## # # #   #   #   #   # #
 ## #   #     # # # #     # #   # #   #   #  #       #   #       # #
 ## # # ####### ### ####### # ### # # # ###  #   # # #   # # #   # #
 ##   #       #   # #         # #   # #      #   #       #   #   # #
 ## ####### ##### # # ######### ##### #####  #   #   # # #   #   # #
 ## #     # #   # # #         #   #   #   #  #   #       #   #   # #
 ## # ### # # # # # ######### ### # ### # ## #   # # #   #   #   # #
 ##   #   #   #     #             #     #                #     B # #
 ########################################### # # # # # # # # # # # #
 ########################################### # # # # # # # # # # # #