################### #
A               ### #
    ########### ### #
#              #### #
                    #
################### #
#################B  #

#####################