  ###################################################################################################
    #       #     #   #     #                 #           # #   #         #         # #   # #     # #
### # ### # ### ### # ##### #B### # ####### # ### # # ### # ### # ######### # # # # # # ### # # ### #
# #   # # #         # #     # #   # #       #   # # # #         # #   #     # # # #         # #     #
# ### # ### ##### ####### # ####### # # ### ####### # ####### # # # ### # ########### ### ####### # #
#   #   #   # #     #     #   # #   # # #   #   #   # # # #   #         # # # # #       #         # #
### # ####### # ### ##### # ### # # ##### ##### # ##### # # # # # # # ### # # # # ####### # ### # ###
#       #   #   #   #     #     # #   # #       #       #   # # # # # # # #     #     # # #   # #   #
# ### ### ### # # ############# ##### # # ### ### ######### ### ##### # ### ### ##### # ### ### #####
# #   #   #   # #     #       # #       #   #   # #     # #   #   # #       # # #       # # #   #   #
### # # ######### # # ### ### # ####### # # ##### # ### # # # ##### # # # # # # ######### ### ##### #
# # # #   #   # # # #     #   # #     # # #   #   #   # #   # #       # # #   # #     #       #   # #
# ### ### ### # # # ####### # # ##### ### ### ######### # # # ##### ### ########### ##### ### # # # #
#     # #     #   #   # # # #   #     #     # # #   #   # # #     # #   # #   #     # #     #   #   #
# ##### # ### # # ### # # ##### # # ### ### ### # ### ### ############# # # ### ##### ####### ##### #
# #     #   #   #   # #     #   # #     #     # #       #     #     # #         #   #     #     #   #
# # ### # ####### ### # ####### # ### ### # # # # ### # # ######### # ### ####### ### ### ### # # ###
# # #   #     #   #     # #   # #   #   # # #   #   # # # #   #               # # #   #       # #   #
####### # # ####### # # # # ########### ##### ######### ### ####### ######### # # ####### ###########
# #       #     #   # #   #     # #   #   #           # # #       #         #   # #     #   #   # # #
# # # # ##### ##### ####### ### # ### # # # # ######### # # ########### ######### ##### # ##### # # #
# # # #     #   #     #   #   #     #   # # #   #     # # #     #           #         #   #   #     #
# ####### ### # # ####### ### # ######### # ### ### ### # ### ##### ############# ##### ### ##### ###
# # # #     # # # #   #   #   #           # #             # #     #     #         #         #       #
# # # ######### # ### # ### ### # ### ### ### ######### # # ### # # ####### # ########### # ### ### #
#         # #   #         # # # #   # # #   #   #     # #   # # #       # # #   #         #     # # #
### # ##### # ####### # # ### ### # ### ##### # # # ####### # ### # # # # # # # ##### ### ####### # #
#   #     #     #     # # # #     #   # #     # # # #       #   # # # #   # # #   #   #   # # # #   #
### ########### ### ### ### # ##### # # ####### # ##### ####### # ### # ### # ### # ##### # # # ### #
#       # #   # #   # #         # # # #     # #   #     #   # # #   # # #   # #     # #   #       # #
# ### # # # ##### ### # ### # ### ### # ##### ### # # ##### # # ### ############# ### ### # # # ### #
# # # # #       # #     #   # # #   # #   #   # # # #   #     #   #   # #   #       # # # # # # #   #
# # # ##### ##### ####### ### # # # ##### ### # ########### ### ####### # ####### ### # # ##### # ###
# #             #   # # # #   #   # #     #               #       # # #       # # #   #       #     #
# ### # # ### ### ### # # ### ##### # # ### ### ### # ########### # # ##### ### # ### ### ##### #####
# # # # # #   #     # # # #   #       #       # # # #     #   #       # # #     # #   # # #   #     #
# # ####### ##### ### # ##### # ##### # ####### # # ##### # # # ####### # ##### ### # # ##### ##### #
#       # #   #   #   #   #   #     # # #         # #   #   # #           # # # # # # #     # # #   #
# # ##### ######### ### ### # # # # ### # # # # # ### ### # ##### ### ##### # # # # ##### ### # # # #
# #     #         # # #     # # # #   # # # # # #   # # # # # #   #               # #   #   #   # # #
# ##### ####### # # # # ######### # ### ##### ### ### # # ### # ### ### ### # # ### ### ### # ###A###
# #   #   # #   #         #     # # # #     # #   #   #   #     # # #   #   # # #     #     #   #   #
# ### ##### ##### ##### ### ### # # # # # # ##### # ### # # # ### ### ##### ### # ##### ##### ##### #
# # # #   #   #   #     #   #     # #   # # #   # #   # # # # # #         #   #   #   #             #
# # # ### ### ### ##### ####### ##### ### # # ####### # # ##### ### # ##### ####### # # # # # ### # #
# #       #       #   #   #   # #     # # # #         # #           # # #   #     # # # # # #   # # #
# # ##### ##### ##### ##### ### ####### ### # ##### # ########### ##### ### ### ### # # ##### ### ###
# # #   #   # #       # # #     #     #     # #   # #     #   #       #   #     # # #   # #   # # # #
# ### ##### # # ### # # # ### # # ### ##### # ### # # # ##### ### ####### ### ### ### # # ### # # # #
#       #     # # # # # #     # # #   # # #   #     # #         #   # #   #     # # # #   #     #   #
# ######### ##### # # # ### ### # # ### # # ##### ##### ############# # ### ### # # ####### ### #####
# #     #     #   # #     # # # # #   #     #   # #       #   #   #   #   # #   # #           # #   #
# # # ### # ### # # # ####### ####### ##### # # ##### ### # ### # ### ### ####### # ######### ### # #
# # #   # #   # # # # #     #   #     # # #   #   #   #   #     #       #     #         # #   #   # #
# ### ### ####### ### ### # # ##### # # # # # ### # ################# # # # ### ####### # # ### # # #
#       #   # #     #   # #     # # # #   # # # # #                   #   #   # # #   # # #   # # # #
# # # # # ### ### ##### # # ### # ### ### ### # ##### ####### # ######### ##### # ### # # # # # #####
# # # # #         #     # # # #     #     # # #           # # #   # # # #   #   # #   #   # #   #   #
### # # ### ##### ##### # ### # # # ##### # # # # ####### # ### ### # # ### ##### ### ### ### # # ###
#   # # #   #   #       # #   # # # #   #     # #     # # #     #     # # # #   #     # # #   #   # #
### ##### ### ### # # ### # ### # # # ##### ######### # ### ####### ### # ### # # # ### # # ##### # #
# #   # # #     # # #   # #   # # # #         #   #   #                       #   #       # #     # #
# # # # ### ##### ##### # ### # ### # # ### ### ######### ### ##### ##### ############# # ######### #
# # # # # #   #   # #         # #     # #   #   # # #     #       #   #     # #     # # # #     # # #
# ### # # ### ##### ##### # # # # ##### # ##### # # ##### ######### # # ### # # ##### # ####### # # #
# #     #                 # # # #     # #   #         #   #   # # # # # #     #           #   # #   #
# # # # ### # # ### # ### # ### # ##### ### ### ### # # # # ### # ##### ### ##### ######### ### # ###
#   # #   # # # #   # #   # #   # # # #   # #   # # # # #   # #   #       #     #         #   #     #
### ##### ### ### ##### ######### # # ######### # ### ####### # # # ####### ##### ####### # # # ### #
#   #   #   # #   #       #   #                   #         #   # # #   #   #   # #   #     # # #   #
# ### ##### # ######### # ### ### ######### ##### # ### ### # ##### # # # ### ####### # # ### ##### #
#       #       #       #     #   #         #     #   #   # #       # #     #           # #         
################################################################################################### 
