############
#   #      #
A # # #### #
### #    # #
#    ### # B 
#### # # # #
#  # # # # #
## # # # # #
#        # #
###### ### #
#      #   #
############