   ###########################################
         #     #                    #        #
#  ####  #  #  #  ##########  ##########  #  #
#     #  #  #A #     #  #    B      #     #  #
#  #######  ####  ####  ####  ####  #  #  #  #
#        #  #     #  #     #  #  #     #  #  #
#  #######  #  #  #  #  ####  #  ##########  #
#     #        #        #           #     #  #
#  #######  #  ###################  #  #  ####
#     #     #  #        #        #     #     #
#  ####  #######  ##########  #######  #  ####
#  #     #              #  #     #     #     #
#  ####  #  #######  #  #  #  #######  ####  #
#              #     #  #  #        #  #     #
#  #######  #######  #  #  #  ################
#     #     #  #     #     #           #     #
#  ####  #  #  #  ################  #######  #
#     #  #     #     #  #  #  #  #  #     #  #
#######  #  ####  #  #  #  #  #  #  #  ####  #
#  #     #  #     #     #  #           #     #
#  #  #############  ####  #  #######  #  ####
#     #     #  #                 #  #  #     #
####  ####  #  ####  ####  #######  #  #  #  #
#  #  #     #        #        #  #  #     #  #
#  #  ####  #  #######  ####  #  #  #  ####  #
#  #  #  #        #     #  #     #  #  #     #
#  ####  ####  ####  #  #  ####  #  ##########
#           #     #  #  #        #  #     #  #
#  #  #  #######  ####  #  #  #  #  #  #  #  #
#  #  #  #        #     #  #  #        #  #  #
#  #  #######  ##########  #  #  #  #  ####  #
#  #           #  #     #  #  #  #  #  #  #  #
#######  #######  ####  #  #######  ####  #  #
#           #     #  #           #           #
####  ####  #  #  #  ####  ####  #  #  ####  #
#        #     #  #  #        #  #  #  #     #
#  ################  ######################  #
#                 #           #  #  #  #     #
##########  ##########  ####  #  #  #  ####  #
#     #  #     #  #     #     #  #           #
####  #  #  #  #  #  ####  ####  #  #  ####  #
#        #  #        #           #  #     #  #
#  ####  ####  #  ##########  #############  #
#  #     #     #  #     #        #           #
#######  #  #  #  #  #  #######  #############
#        #  #  #  #  #  #              #     #
#  ####  ####  ####  #  #######  ##########  #
#  #                 #     #                 #
#  #############  #############  ##########  #
#  #  #  #        #     #        #     #  #  #
####  #  #  #  ####  ####  ####  ####  #  ####
#        #  #     #        #              #  #
####  ####  #  ####  #######  #  ####  ####  #
#           #     #        #  #  #           
###########################################  
