  #####################################################################
  #       #           # #   #     #       # # #       #   #           #
# # ### # # ##### # ### # ### ##### ##### # # # # ####### ### # ##### #
# #   # # #   #   #   # #       # # #     #   # #  A  # #     #   # # #
# # # ##### ### # # ### ### ### # ####### # ### ##### # # ######### # #
#   # #     #   # #   # #   #     #               #           #     # #
# # ### ####### ##### # ####### ### # ### ##### # ####### # ### ##### #
# # #     # # #   #   #     #   # # # #   # #   #       # #       # # #
# ##### # # # # ######### ### # # # ##### # ##### ####### ####### # ###
# #     # #     # #   #   # # # # #     # #   # #       #   # #       #
# ##### ##### ### # ### ### # ### # # ### # ### ####### ### # # #######
# #   # #     #   # #     #         # #     # #     # # #     #       #
# # # ### # ### ### # ##### # ### ######### # ##### # # ### ##### # ###
# # #     # # #     #   # # # #     #   # #     #         # # #   #   #
# ##### ### # # ### ### # ### ######### # ####### ##### ### # ##### ###
#     # # #     # #   # # #       #         #   # #   # # # #     #   #
### ##### # ##### ### # # ### ####### ### ##### # # ##### ##### # ### #
#     # # #   #     # #     #     #     # #   #       #   #   # #     #
##### # # ####### # # ### # ### ### ### ##### # ### ### ### ##### ### #
#               # #       # #   #   #   #     #   # #   #     # #   # #
### ######### # # ############### ##### ### # ### # ### # # # # ##### #
#         #   # #         #   # #     # #   #   # #     # # #       # #
# ##### ##### ######### ### ### ### ##### ### ##### ####### # # ### # #
#     # #   #               #   #   # #   # #     #     #   # # #   # #
# # ### # # # ####### # ##### # # ### ### # ### ### # ### ##### ##### #
# #   # # # #     #   # #     # #   #       # # #   #   # # #         #
# # # ### ##### # ### # ####### ### # ##### # ### ##### ### ### ### # #
# # #   #   #   #   # #     # # #         # #     #       #     #   # #
# ### # # # ######### ### ### # # ### ##### ##### ### # # ### # ##### #
# # # # # #             # # #     #   # # # #     # # # #   # #   #   #
# # # # ######### ### ##### # ######### # # # # ### # ########### ### #
# #   # # #         #     #       #   #     # # # #   #       # #   # #
# ##### # # ####### ### # # ### # ### # # # ##### ### ####### # ### ###
# #     #     #   #   # # # #   #   #   # # #       #   #   #   #   # #
################# # ####### ##### ##### # ##### ### # ##### ### # ### #
# # #   # # # #         #   # # # #   # #         # #           #     #
# # # ### # # ##### # ####### # ### ######### # ### # ### # # ### ### #
#     # # #   B   # #         # #   # # #   # # # #     # # #   #   # #
# ##### # # ##### ##### # ### # # ### # # ####### ### ############# ###
# # # #   #   #   #     # #   #   #   #     #         # #   #         #
# # # # ### # # # # # ### ####### ### ##### # # # # ### ### ### # ### #
#           # # # # #   #   # #         #     # # #   #   # #   # #   #
# ### ####### ### ### # ##### ##### ### # # ##### ##### # # ###########
# # #   # #     # #   #         #   #     # #     #   # #     #       #
### # ### ### ### ##### ##### ### # # # ##### ##### ### ##### # ##### #
#     #     # #     #     #       # # #   # # # #   # # #     #   #   #
##### # ##### ####### ### # # # ##### ##### ### ### # # # ### # ### # #
# # #       #   #   #   # # # #   #   #   # # #     # # # #       # # #
# # ### # # # # ### # ##### # ####### ### # # ##### # # ### ##### # # #
#     # # # # #       #   # # # #         #   #       # # #   # # # # #
### # # ##### ### ####### ##### # # # # # ### ##### ### # ### # ### ###
#   # #     # # #   #     #     # # # # #         #     #   # # #   # #
### # # # # ### ### # ### ##### ########### # ### ######### # # # # # #
#   # # # #   # # #     #       # #     #   #   # #       #   #   #   #
# # ### ### ### # # # ########### # ### # ##### ##### ####### ### ### #
# #       #       # #     #       # #   #     #   # #   #     #     # #
##### ### ### ### ### ##### ### # # ##### # ##### # # ### # ##### #####
#       #   # #   #   #     # # #     #   # # # #       # #     # # # #
# ##### ####### ##### # # # # ##### ##### ### # ##### ##### ### # # # #
#     #     # # # # #   # # #       #   #   #   #     #       # #   # #
### ### # ### ### # ### ### # ######### ##### ### # ### ##### ####### #
#     # #   #           #   #   # # #   #       # #     # # # #   #   #
##### ######### ##### ####### ### # ### ### # ##### ##### # # ### # # #
#     # #         # # #     #       # # # # # # #     #   #   #     # #
##### # # # ####### ####### # ##### # # # # # # ### ### ### # # ##### #
#     #   # #       #       # #   #     # # # #     #     # #       # #
### ######### # ####### ### ### # # # # # ### # ### ### ####### # # # #
# #   #   #   # #     #   #     #   # # #       #     # #       # # # #
# # # # ### # ### ### ##### ### ### # # ##### # # # # # ##### # ##### #
#   #   #   # #     # #       #   # # #   # # # # # #   #   # # #     #
# ### # # ### # # ### ### # ##### ######### ####### ### ### ### ### ###
#   # #   # #   #   # # # # #   # #   #               # #     # #     #
# ####### # # # ### ### ####### # ### ##### ### ##### ### ### ### #####
# # #   # # # # # # #           # #         #       #   # #   # # # # #
### # ##### ### # # ### # # # ### ##### ######### # ####### ### # # # #
#     #   #       # #   # # #       #   # #     # #       #           #
### # # ### ### # ### ### # ##### ### # # ### ##### ### # ### #########
#   #     # #   #   #   # #     # #   # #     # # # #   # # # # #     #
##### ##### ### ################# ####### ##### # # ##### # # # # ### #
#   # #   #   # #   #           #     #       #   # #   # #         # #
### # ### ### ### ### ######### ### ##### # ### ##### # # ### ### ### #
#       #         #   #   #   # # #   # # # #         #   #     # #   #
##### ##### ##### # ##### ### # # # ### ### ### ### ##### # ### ##### #
#       # #   #       #   # #     # # #           # #   # #   # #     #
# ### ### ##### # ### ### # # ##### # ##### ### ####### ############# #
# #             # #     #       #     #       #   #     #   # #       #
######### # # ##### ##### ### ####### ### ### ##### ### # # # # ### ###
#     #   # #   #       # #       # #   # #   #     #     # #     #   #
# ### # # ##### ### ######### # ### # ### ### ### ##### ### ### # ### #
# # # # # # #     # #     #   # # # #   # #         #   #     # # # # #
# # ### ### # # ### # ### # ##### # ### # ####### # ##### ### ##### # #
#       # #   # #   # # # # # #     #   #   #   # # #     # #   #     #
# ### # # ####### # # # # ### # # ##### # ### # ####### ### ##### #####
# #   # #   # # # # # #   #     #   #   #   # #     # # # # #   # #   #
####### ### # # ####### ####### # ######### # # # ### ### # ### # # # #
#                       # #     # #         # # #     # #     #     # #
# ### # ### ### ####### # # ##### # ### # ### ##### ### # # ### ### ###
#   # # #     #   # #   #   #       # # #     #     # #   #   # #     #
### ##### ####### # ### ### # ### # # ##### ##### # # # ######### ### #
#   #           #     # #   # #   #   #     #     #         #       # 
##################################################################### 
