  ###################################################################################################
        #   #       #             #       #   #         #   #                 #       #           # #
# ### ##### # ### ####### ### ####### ####### # ######### # # ####### ##### # ##### ### # ### # # # #
#   # #     # #     #   # #   #     #       # #           #     # # #     # # #     #   #   # # # # #
##### # # ### ##### ### ### # # ####### ##### # # # ##### ####### # ### ########### ### ####### ### #
#   #   # #   # #   # #     #         # #       # #   #             # #     # #         #   # #     #
# ### ######### # ### # ##### # ##### # # # # # # # ######### ##### # ##### # ##### # ##### # # #####
#       #   #             # # #     # #   # # # # # # # # # #     # #     #   # #   # #       # #   #
# # ### # # # # # ######### # ##### ##### # ######### # # # ########### ### ### ### ####### ####### #
# #   # # # # # # # #         # #         # #       #   #   # # #           #               #       #
# ### ### ### # ### ####### ### ### # ### # ####### ### # ### # ### ### # # ####### ############# # #
# #     # #   # #     # #       #   # #   #     #   #   # #   #   # #   # #     #     # # #   #   # #
# ##### # ### ### ### # ##### ### ####### ### ### # # ### # ### # # ####### ######### # # # # ##### #
# #         #     #   #         #   #     # #   # # #     #   # # # #     # # #         #   # #     #
### # ### # ##################### ### # ### ####### ### # # # # ####### # ### # ##### ##### ##### ###
# # #   # # # #       #   #         # #           #     # # #   #   # # # # # #   #   #       #     #
# # ### # ### ### # # # # ### ######### # # ####### ### ####### # ### # ### # # ##### ### # # ##### #
#     # # #   # # # #   #   #       #   #A#     # #   #   # # #     #   #     # #   # # # # #   # # #
# # ### # ### # # # ####### # ####### # # ### # # ### ##### # # ##### # ##### # # # ### ### ### # # #
# # #   #       # # #   #           # # # #   # #             # #     #   #   #   # # # # # #       #
### ### ##### ####### # # ### ##### # ####### # # # ##### ##### ##### ##### # # # ### # # ### ### ###
#     #   #     # # # #   #     #   # #       #   #   #   # #           # # #   # # #     # #   #   #
# ##### # ####### # ##### ### # ############### ### ### ### # ########### # ####### ### # # # # # ###
# #     # #     #     #   #   #   # # #   #       # # #           # # # #   # #   # # # # #   # # # #
# ##### ####### ### ### # # ### ### # # # # # # ##### ### # ##### # # # ### # ### # # ### # ##### # #
# #   #   #     #   #   # # # # # # # # # # # #   #   # # #   # #   # # # #   #       #       #     #
# # # ### # ### ### ##### ### ### # # # ####### # # ### # ##### # ### # # # ####### # # # ####### # #
#   # # #   # #         #       #       #   #   # #     # # #     #   #     # # # # # # #   #     # #
####### ##### ####### ######### # ### # ### ### ### # ### # ### # # ####### # # # # # ##### ####### #
#   # #       #     # #           #   #   # #     # #       #   #       #   #   # # # #   #     # # #
# ### # # ######### # # ##### ####### ### # ################# # # # # # # ### ### # # ### # ### # # #
# #     #     #       # #     # #   # #     # #     #     # # # # # # #     # #     # #       # #   #
# # ##### ### ### ### ### ##### ### ####### # ### ####### # ### ####### # ### # # # # # # # ##### ###
#     #   #     # # #   # #   # #     #       #         #     # #   #   #   #   # # #   # #   #     #
############### # # # ####### # # ##################### # # # # # # # # # ####### ######### ### #####
#     #   #   #   #   # #   #     # # #     # #       #   # #   # # # # # # #           # #   # #   #
# # ### ### ####### ### # ####### # # ##### # # # # ########### ### # ##### ### ### # ### ### # # # #
# #   # # #     # # #               #       #   # # #         # #   # # #   #   #   #       # # # # #
# ### # # ### ### # ### # ### ### ##### ####### ### # # # # ### # ##### # ##### ##### ############# #
#   # #     # #   # #   # # # #     #     #       #   # # #       #   #   #   #   # #   #       #   #
# # ##### ### ### # # ##### # ### ### # ##### ##### ##### ########### ### # # ### # ######### ### ###
# #   # #         #       #   # #   # # # # # # #     # # # #     # # #     # # # #     #   # #   # #
### # # # ### # ############# # # ### # # # ### # # ### # # ##### # # ##### ### # # # ##### # # ### #
#   #   #   # # #     #     # #       #   #     # # #   #   #       # #   #       # #       #       #
### ### # # # ### ### ### # ##### # # # ### ### # ##### ### # ####### # ### ### ##### ##### ####### #
#     # # # # # # #       #     # # # # #     #       #   # #   #         #   # # # #   #   #       #
### ### ### ### ####### ####### ##### ############# ##### # # ### ### ##### ### # # ### ##### ### ###
# # #         #   #     # #   # #       #   #   #     #           # #   #     #     #   # #     #   #
# # ### # # ### ##### ### # ####### # ### ##### # # ### ### ### # # ####### ### ####### # ### ### ###
#     # # #   #     # # # # # # #   #     # # #   # #     #   # #     #     #     # #     # # # #   #
# ##### ####### # ### # # # # # # ### ##### # # ### ##### ### ### # ##### ### # ### # # ### ### ### #
# # # #   #     #         # #   # #     # #   # # # # #   # # #   #         # #   #   #   #         #
# # # ### ### ######### ### # ### # # # # ### # # ### # ### ### ############# ##### # ############# #
# # #           # #         #   # # # # #         #       #       # #     #   # #   #       #       #
### # # ##### # # ### ##### # # # ### ##### ##### # # ##### ##### # # # ####### ### # ### ####### ###
#     #   #   #   # #   #     #     #     #   #   # # # # #   #     # # # # #   #   # # #   #   #   #
####### ### # ### # ######### ########### # ##### ##### # # ##### # # # # # # ####### # ### ### ### #
# # #     # #   #     #               #         #     #   # #     #   # #     #   # #   # # # # #   #
# # ######### ######### ### ####### # # ### ### # ####### ######### ####### # # # # ### # # # # # ###
#   #     # # # #     # # #   #   # # #   # # # #     # #   # #   # #     # # # #   # # #         # #
### ### ### # # ### # # # # ##### ##### ### # ####### # ### # # ### # # ### ### ### # ### ### ### # #
# # #   # #     #   #   #   #       #   #     # #         #       # # #     # # # # #   # #   #     #
# # # ### ### ##### ### ### # # ### # ####### # # ### # # # ##### # ##### ### ### # ### # ### ### # #
#               #     # # #   # #   # #   #     # #   # # # #       #       #   #         # #   # # #
# ##### # ####### ##### # ### ##### ##### ##### ### ####### # # # ### ####### ##### ### ### # #######
# # #   # #     # #   # # #   # #   #     #       # #       # # # #         # # #   #       #   #   #
# # ####### ##### # # ### # # # # ##### # ######### ####### ### # # # ##### # # ### # ##### ##### # #
#   # #   #     #   #   # # # # # #     #         # # # # #   # #   #   #   # #   # #     # #     # #
# ### # ### ### # ##### # # ### # # ##### # ######### # # ### ### ### ##### # # # ### ##### ##### # #
#     #       # #   # # #   # #     #   # #     # #     #       # # #   #     # #       #         # #
### ##### ### ### ### ### ### ######### ### # ### # ### # # ####### ##### ### ### ### ### ### #######
#   # #     #   #   # # #     # # # #       #     # #   # #     #     # #   #   # #     # # #   # # #
# # # ####### ### ### # # # ### # # ####### # ######### ##### ### # # # # ### ############# # ### # #
# #     #   #         #   #   #           # #   # # # #     # #   # #   # #   #             #     # #
### ### # ### ### ### ##### # ##### # ##### ### # # # ### ######### ##### ### ### ### ####### # ### #
#   # #     # # # #       # # # #   #   #     #   #   #       #         # # #   #   #   # #   #     #
# # # # # # ### ### ######### # ####### ########### # ##### # ##### ####### ### # ### ### ### ##### #
# #   # # #   # #       #   # # # #   #     #     # #       # #   #     # #       # #     # # # #   #
# ##### ### ### ### ### # ##### # ### ##### ### ##### ### ### # # # # # # ### ### # ####### # # ### #
# #       # #   # # # # # #   # #   #     #   #     # #     #   # # # #         #       #   #   #   #
# # ### ### # # # # # # # # ### # # # # ##### # ### ########### ########### ##### # # # # ### # # # #
# # #     #   # #     # #   #   # #   # # # # #   #         #     #   # #     #   # # #       # # # #
### ########### ### # # # ##### ##### ### # # # ####### # ####### ### # ### ######### ########### ###
#     #   # #   # # # # #   #       # #     #   #       #     # #     # #       # # # # # #     #   #
# ##### # # ### # ### ##### ##### # # ### ### ### ##### ### ### ##### # # # ### # # # # # # ####### #
#     # # #   # # #     #       # #   #       #   #     #                 # #   #           # #     #
# # ##### ### # # ##### ####### # ### ### # ### # ######### ### ##### ### ### ### ########### ##### #
# #       #   #   # #   #     # #   # #   #   # #   #   # # #       #   # #   # #   # # # #   #     #
# ### # ### # # # # ### # # # # # ##### # # ##### # # ### ### ### ####### ### # # ### # # # ####### #
# #   # #   #   #     #   # # #     #   # #   #   # #   #       # #     # # #   #   #   #   #   # # #
### ########### # ##### ##### ### ### # ##### # ### # # # ### # ##### ##### ### ### # # # ##### # # #
#     #   #   # #   # #   #   #   #   #   # # # #   # #   #   #   # #   #       # #   #   #   #   # #
##### # # ### ### # # ### # # # ######### # ##### ########### ### # # ### ### ### ### ##### # # ### #
# #   # #     # # # # #   # #   # #   # #     #     #   #   #   # #   #   # #       # #     # # #   #
# ##### ##### # ### # ### ### # # # # # ##### ### ### ##### # ### ### ##### ### ########### ### ### #
#   #   # #     #     #   #   #     #   # # # #   # # #   #   #   # #     #   #   #       # # #     #
# ####### ##### ##### ####### ####### ### # ##### # # ### # ####### # ### ### # # # # ### # # ##### #
#       #                 # # # # # #   #   #     #     #           # # #   # # # # #   #   # # #   #
# # # ### ######### # ### # # # # # # # ### ### # ##### ##### ### # # # # # # ### ### ####### # # ###
# # #         #     # #     #     #   #       # #   #         #   # #   #B#                 #       
################################################################################################### 

