  ###################################################################################################
          #     #   #     #   #       #         #   # #   #     #   #   # #     #   #   # # #     # #
# ##### # ##### #A# # # # # ####### # ####### # # ### ### ##### # # # # # # # ##### # # # # ### ### #
# #     #   #     #   # #           #     #   #       #     # #   # # #     #         #   #   #     #
# ### ######### ##### # ##### ### # # ### # # ### ####### ### # ### ####### ##### ######### # ### ###
#   # #       # #   # # #   # #   # # #   # #   #     #       # # # # # #     #   # #       # # # # #
# ######### # ### ####### ### # ### ##### ### # # ##### ### ##### # # # ### ####### # ####### # # # #
#       # # #       #         # # #   #   #   # #     # # #   #     # #                   #   #   # #
# ####### ### ### ##### ### ### # # # # ### ### # ### ### # ### ### # # # # # ##### ### # # ##### # #
#   # #     #   #       # # #   #   # #     #   # #         # # # #   # # # # #       # # #     #   #
# # # ##### ####### # ### ############# # # # ### ### # ### # # # # # ##### ########### ##### ##### #
# # # #   # # #     # # #     # #       # # #   # #   # # #   # #   # #   #   #         #   #       #
### # # ### # # # # ### ### ### ### ######### # ####### # ### ### # ### # # ##### ### # # ###########
#     #     # # # #   #   # # #       #   #   # # #         # # # #     # #   #     # # #   # # # # #
### # ### # # ##### ### # # # # ### ### # ### ### ##### # ##### # # ### ############### # ### # # # #
#   #   # #             # #   # # # #   #   #   # #     #     #   #   #     #                 #     #
####### ####### ### ### ##### # # # # ### # # ### # ### ### # # # ### # ### # ############# ### #####
#       # # #   # # # #   #   #   # # #   # # #     #     # # # #   # # #       #         #   #     #
# ####### # # ### ### # # # # # ### # ##### ##### # ####### ########### # ### # ##### # # ######### #
# #     # #     #   # # #   # #   #     # #   #   # # # #   #     #   # # #   #     # # #       # # #
# # ### # ### ### ### ##### ### ### ##### # ### ### # # ##### ### ### ##### ### ### # ##### ##### # #
# # #     #   #     #   #   # # #       # # #     #       # # #   #     # # #     # #     # # #     #
# ### ### # # # ##### # # ### ### # ### # ##### ##### ##### # ### # ##### # ### ##### ##### # # #####
#   # #   # # # #     # #       # # # #       # # #         #   #             #   # # # # # # #     #
### # # # # ### ####### # ##### ##### # ##### # # ######### ### ##### # ### ### # # ### # # # # #####
#     # #   #   #         #     # #   # #   # # #   # # #   #   #     #   # # # # #       # #   #   #
# ### ######### # ####### ### ### # # ##### ### # # # # ####### # ### ##### # # ### ### ### ### ### #
# #   # # #     #     #     # # #   # # #     #B# #     #   # # # # #   # #   #   #   #       #   # #
### # # # # ######### ####### # ### # # # ### # # # ##### # # # ### ##### # ######### # ### # # # # #
# # # #   #       # # #   # #       #   #   # # # # # #   # #   # # #   # #   # # #   # # # #   # # #
# # # ### ####### # ### ### ### ### # # # # ##### ### # ##### ### # # ### ### # # ####### # ### ### #
#   #       # #           #       # # # # # # # #       #     #     #         #           # #       #
### ### ##### # ####### ######### ##### # ### # ### # # ### ####### # ##### ##### ### # # # # ##### #
#   #     #   #   # # #   #       # #   # # #     # # #         # #     #     #   # # # #   # #   # #
##### ##### # ### # # # ##### ##### ### # # ### ##### # ### ##### ### ####### ##### ##### # # # # ###
#   #   #   # # #   # #   # # #   #   #   #     #     #   #   #         # #     #     # # # #   # # #
# ### ####### # # ### # ### # ### # ##### # # ##### # ##### ### # ##### # ### # # # ### # ######### #
#   #   #     #     #     #   #     # #     #   # # # #     #   # #   #   #   # # # # # #   #       #
# ####### # # ##### ##### ######### # ##### # # # # ####### ##### ### # # ### ### # # # ### ### #####
#     #   # #     # # #       # #     #   # # # #   #       #   #     # #   # #   #       # #   #   #
# ##### ### # ####### # ####### # # ### ### ### # # ### # ##### # # ### # ##### ######### # # # # ###
#   # #   # #   #   #   # #     # #       # #   # # #   # #   #   # # # #   # #     #   #   # # #   #
# ### # # # # ##### ### # # ######### # # # ####### # ### ### ### ### ##### # # ### ### ####### ### #
#   # # # # #                         # #     # # # #   #   #           #     #   # # #   # #     # #
# ### # # ##### # # ######### ##### # # ####### # # ################# ### ### # # ### # # # ### ### #
#     # # # #   # # # # #         # # # #     #       #   #     #     # #   # # #   #   #           #
# # ##### # # ### # # # # # # ######### ##### # # # # # # ##### ### ### ### # ### ### ##### ####### #
# #   #     # # # #     # # #     #             # # # # # #   #         #   # #         # #   # #   #
# ### ### # # # ### # ######### ######### ####### ##### # ### ####### ##### ### ### ##### ##### ### #
# # # # # # #   #   # # #   # #   #     #       #   #   # #   # # # #   # #     #             #     #
# # ### ####### ### ### # ### ####### # # # ### ### ### # ### # # # # ### ######### ### ########### #
#   # #   #   #   #       # # # # #   #   #   #   #     # #                   #   # #   #   #       #
### # # # ### # ### ####### # # # # ##### # # ####### ####### # ####### ##### ### # ### # ### #######
# #     #       # #       #       #   #   # # #     # #       # #           # # #     #     # #     #
# ##### # ####### ### ### # ####### ### # ### ### # ##### # ##### ### ### ### # # ### ####### # # # #
#       # #           #       #       # # #       # #     #   #   #     #   #   # #   #         # # 
################################################################################################### 
